01 02 05 05 05 05 05 05 05 05 05 05 05 05 06 07 
03 04 05 05 05 05 05 05 05 05 05 05 05 05 08 09 
10 11 00 00 00 00 00 00 00 00 00 00 00 00 12 13 
10 11 00 22 00 22 00 22 22 00 22 00 22 00 12 13 
10 11 00 20 00 20 00 20 20 00 20 00 20 00 12 13 
10 11 00 22 23 22 22 00 22 00 22 00 22 00 12 13 
10 11 00 20 22 20 20 22 20 00 20 22 20 00 12 13 
10 11 00 22 20 22 00 22 00 22 22 20 22 00 12 13 
10 11 22 20 00 20 00 20 00 20 20 00 20 22 12 13 
10 11 20 22 00 22 00 22 22 00 22 00 22 20 12 13 
10 11 00 24 00 20 00 20 20 00 26 00 20 00 12 13 
14 15 18 18 18 18 18 18 18 18 18 25 18 18 16 17 
22 22 22 22 22 22 22 22 22 22 22 22 22 22 22 22 